  __  __           ____________ 
 |  \/  |   /\    |___  /  ____|
 | \  / |  /  \      / /| |__   
 | |\/| | / /\ \    / / |  __|  
 | |  | |/ ____ \  / /__| |____ 
 |_|  |_/_/    \_\/_____|______|
                                
                                